login=LoginServlet
search=SearchLastnameServlet
logout=LogoutServlet
register=RegisterServlet
deleteAccount=DeleteAccountServlet
index=home.jsp
registerPage=register.jsp
errorPage=error.html
loginPage=login.jsp
practiceDetail=CreatePracticeServlet
quizListPage=quizlist.jsp
quizPage=quizPage.jsp
practiceList=PracticeListServlet
homepage=HomeServlet
adminCourseSer=GetAllCourseServlet
viewdetailcourse=subjectlist.jsp
subjectListDetail=GetSubjectPagingServlet
subjectlesson=GetLessonBySubjectID
loadQuestion=LoadQuestionServlet
getRandomQuestion=GetRandomQuestionServlet
adminUser=userManagement.jsp
getAllUser=GetAllUserServlet
editUser=EditUserServlet
deleteUser=DeleteUserServlet
viewProfile=getUserByIDServlet
profilePage=userProfile.jsp
getProfileToEdit=GetUserToEditServlet
editPage=editUserProfile.jsp
adminCourse=courseManagement.jsp
adminSubject=subjectManagement.jsp

